Allen_Brain_Atlas_10x_scRNA_2021	Cell_Types
Allen_Brain_Atlas_down	Cell_Types
Allen_Brain_Atlas_up	Cell_Types
ARCHS4_Tissues	Cell_Types
Azimuth_Cell_Types_2021	Cell_Types
Cancer_Cell_Line_Encyclopedia	Cell_Types
CCLE_Proteomics_2020	Cell_Types
CellMarker_Augmented_2021	Cell_Types
Descartes_Cell_Types_and_Tissue_2021	Cell_Types
ESCAPE	Cell_Types
GTEx_Tissue_Sample_Gene_Expression_Profiles_down	Cell_Types
GTEx_Tissue_Sample_Gene_Expression_Profiles_up	Cell_Types
Human_Gene_Atlas	Cell_Types
Jensen_TISSUES	Cell_Types
Mouse_Gene_Atlas	Cell_Types
NCI-60_Cancer_Cell_Lines	Cell_Types
PanglaoDB_Augmented_2021	Cell_Types
ProteomicsDB_2020	Cell_Types
SysMyo_Muscle_Gene_Sets	Cell_Types
Tabula_Muris	Cell_Types
Tabula_Sapiens	Cell_Types
Tissue_Protein_Expression_from_Human_ProteomicsDB	Cell_Types
Aging_Perturbations_from_GEO_down	Crowd_GEO
Aging_Perturbations_from_GEO_up	Crowd_GEO
Disease_Perturbations_from_GEO_down	Crowd_GEO
Disease_Perturbations_from_GEO_up	Crowd_GEO
Drug_Perturbations_from_GEO_down	Crowd_GEO
Drug_Perturbations_from_GEO_up	Crowd_GEO
Ligand_Perturbations_from_GEO_down	Crowd_GEO
Ligand_Perturbations_from_GEO_up	Crowd_GEO
MCF7_Perturbations_from_GEO_down	Crowd_GEO
MCF7_Perturbations_from_GEO_up	Crowd_GEO
Microbe_Perturbations_from_GEO_down	Crowd_GEO
Microbe_Perturbations_from_GEO_up	Crowd_GEO
RNA-Seq_Disease_Gene_and_Drug_Signatures_from_GEO	Crowd_GEO
Single_Gene_Perturbations_from_GEO_down	Crowd_GEO
Single_Gene_Perturbations_from_GEO_up	Crowd_GEO
Achilles_fitness_decrease	Disease-Drugs
Achilles_fitness_increase	Disease-Drugs
ARCHS4_IDG_Coexp	Disease-Drugs
ClinVar_2019	Disease-Drugs
COVID-19_Related_Gene_Sets_2021	Disease-Drugs
dbGaP	Disease-Drugs
DisGeNET	Disease-Drugs
DSigDB	Disease-Drugs
GWAS_Catalog_2023	Disease-Drugs
HDSigDB_Human_2021	Disease-Drugs
HDSigDB_Mouse_2021	Disease-Drugs
Human_Phenotype_Ontology	Disease-Drugs
Jensen_DISEASES	Disease-Drugs
LINCS_L1000_Chem_Pert_Consensus_Sigs	Disease-Drugs
LINCS_L1000_CRISPR_KO_Consensus_Sigs	Disease-Drugs
MSigDB_Computational	Disease-Drugs
MSigDB_Oncogenic_Signatures	Disease-Drugs
OMIM_Disease	Disease-Drugs
OMIM_Expanded	Disease-Drugs
Orphanet_Augmented_2021	Disease-Drugs
PhenGenI_Association_2021	Disease-Drugs
PheWeb_2019	Disease-Drugs
Proteomics_Drug_Atlas_2023	Disease-Drugs
Rare_Diseases_AutoRIF_ARCHS4_Predictions	Disease-Drugs
Rare_Diseases_AutoRIF_Gene_Lists	Disease-Drugs
Rare_Diseases_GeneRIF_ARCHS4_Predictions	Disease-Drugs
Rare_Diseases_GeneRIF_Gene_Lists	Disease-Drugs
TG_GATES_2020	Disease-Drugs
Chromosome_Location_hg19	Misc
Data_Acquisition_Method_Most_Popular_Genes	Misc
InterPro_Domains_2019	Misc
Pfam_Domains_2019	Misc
GO_Biological_Process_2023	Ontologies
GO_Cellular_Component_2023	Ontologies
GO_Molecular_Function_2023	Ontologies
Jensen_COMPARTMENTS	Ontologies
MGI_Mammalian_Phenotype_Level_4_2021	Ontologies
ARCHS4_Kinases_Coexp	Pathways
BioCarta_2016	Pathways
BioPlanet_2019	Pathways
BioPlex_2017	Pathways
Elsevier_Pathway_Collection	Pathways
Humancyc_2016	Pathways
huMAP	Pathways
KEGG_2019_Mouse	Pathways
KEGG_2021_Human	Pathways
LINCS_L1000_Kinase_Perturbations_down	Pathways
LINCS_L1000_Kinase_Perturbations_up	Pathways
MSigDB_Hallmark_2020	Pathways
NCI-Nature_2016	Pathways
NURSA_Human_Endogenous_Complexome	Pathways
Panther_2016	Pathways
Reactome_2022	Pathways
SubCell_BarCode	Pathways
Virus-Host_PPI_P-HIPSTer_2020	Pathways
WikiPathway_2021_Human	Pathways
WikiPathways_2019_Mouse	Pathways
ARCHS4_TFs_Coexp	Transcription
ChEA_2022	Transcription
ENCODE_and_ChEA_Consensus_TFs_from_ChIP-X	Transcription
ENCODE_Histone_Modifications_2015	Transcription
ENCODE_TF_ChIP-seq_2015	Transcription
Epigenomics_Roadmap_HM_ChIP-seq	Transcription
lncHUB_lncRNA_Co-Expression	Transcription
miRTarBase_2017	Transcription
TargetScan_microRNA_2017	Transcription
TF_Perturbations_Followed_by_Expression	Transcription
TF-LOF_Expression_from_GEO	Transcription
TRANSFAC_and_JASPAR_PWMs	Transcription
TRRUST_Transcription_Factors_2019	Transcription
ARCHS4_Cell-lines	Cell_Types
GeDiPNet_2023	Disease-Drugs
GeneSigDB	Disease-Drugs
IDG_Drug_Targets_2022	Disease-Drugs
PFOCR_Pathways_2023	Pathways
The_Kinase_Library_2023	Pathways
